BACK	B AE K
COMMANDS	K AH M AE N D Z
DON'T	D OW N T
DON'T(2)	D OW N
EMERGENCY	IH M ER JH AH N S IY
EMERGENCY(2)	IY M ER JH AH N S IY
FAQ	F AE K
FIND	F AY N D
GO	G OW
HOME	HH OW M
IN	IH N
NEAREST	N IH R AH S T
PLEASE	P L IY Z
REDEEM	R IH D IY M
SERVICES	S ER V AH S AH Z
SERVICES(2)	S ER V IH S IH Z
SHELTER	SH EH L T ER
SHELTERS	SH EH L T ER Z
SHOW	SH OW
SIR	S ER
START	S T AA R T
TAKE	T EY K
TO	T UW
TO(2)	T IH
TO(3)	T AH
WHAT	W AH T
WHAT(2)	HH W AH T
